2 18 26
##########################
#%   *                 ^ #
#     *   ################
#      *  D              #
#F        # *       $    #
###########              #
#    @                &  #
#            *           #
#^                       #
#          ###############
#     &       *          #
#                     $  #
#         ^    *         #
##############           #
#                        #
#   +                  ^ #
##########################