1 16 27
###########################
#     +                *  #
#                         #
#          %      @       #
################          #
#         &               #
#                    $    #
#     *                   #
#        #            &   #
#   ^    # F              #
#        #                #
#        #          *     #
#        #                #
#####D####                #
#   *  * #     ^          #
###########################
